................
................
................
.....00es00.....
.....001100.....
.....123321.....
.....111111.....
.....111111.....
.....111111.....
................
................
................