................
................
................
.....000000.....
.....000000.....
.....0000e1.....
.....s11111.....
.....000011.....
.....000000.....
................
................
................