................
................
................
.....11e0s1.....
.....100001.....
.....110011.....
.....110011.....
.....111111.....
.....111111.....
................
................
................