................
................
................
.....000s00.....
.....0e1211.....
.....000101.....
.....011211.....
.....010100.....
.....011100.....
................
................
................