................
................
................
.....1s11e1.....
.....101101.....
.....101111.....
.....101111.....
.....100001.....
.....111111.....
................
................
................