................
................
................
.....11110e.....
.....111111.....
.....111011.....
.....11100s.....
.....100111.....
.....111111.....
................
................
................