................
................
................
.....11110s.....
.....101101.....
.....101011.....
.....11e011.....
.....110111.....
.....111111.....
................
................
................