....................
....................
.S1111111112222222..
...........1.....2..
...........1.....2..
...........1.....2..
...........1111112..
.................1..
.................1..
.................1..
.................1..
.................1..
.................E..
....................
....................