................
................
................
.....000000.....
.....000000.....
.....s1111e.....
.....000000.....
.....000000.....
.....000000.....
................
................
................