................
................
................
.....111111.....
.....101101.....
.....111111.....
.....1111se.....
.....101101.....
.....111111.....
................
................
................