....................
....................
....................
.........111........
.........1.1........
.........1s1........
.........111........
....1112222222111...
....1..1..1..1..1...
....1..1..1..1..1...
....1..1112111..1...
....1.....e.....1...
....1111111111111...
....................
....................