................
................
................
.....00es00.....
.....001100.....
.....122221.....
.....110011.....
.....111111.....
.....111111.....
................
................
................