................
................
................
.....s.1111.....
.....1.11.1.....
.....11.1.1.....
.....11.e11.....
.....111.11.....
.....111111.....
................
................
................