................
................
................
.....000000.....
.....000000.....
.....00se00.....
.....000000.....
.....000000.....
.....000000.....
................
................
................