................
................
................
.....000s00.....
.....000100.....
.....000100.....
.....01121e.....
.....010100.....
.....011100.....
................
................
................