................
................
................
.....000000.....
.....000000.....
.....00111s.....
.....e11000.....
.....000000.....
.....000000.....
................
................
................