................
................
................
.....00es00.....
.....001100.....
.....122221.....
.....110011.....
.....110011.....
.....110011.....
................
................
................