................
................
................
.....11s000.....
.....111100.....
.....111111.....
.....1000e1.....
.....101101.....
.....111111.....
................
................
................