................
................
................
.....1e0000.....
.....111100.....
.....1101s1.....
.....110101.....
.....000111.....
.....000000.....
................
................
................